Alabama=>Alabama
Alaska=>Aljaska
American Samoa=>Američka Samoa
Arizona=>Arizona
Arkansas=>Arkanzas
California=>Kalifornija
Colorado=>Kolorado
Connecticut=>Konektikat
Delaware=>Delaver
Florida=>Florida
Georgia=>Džordžija
Guam=>Gvam
Hawaii=>Havaji
Idaho=>Ajdaho
Illinois=>Ilinois
Indiana=>Indijana
Iowa=>Ajova
Kansas City=>Kanzas Siti
Kansas=>Kanzas
Kentucky=>Kentaki
Louisiana=>Luizijana
Maine=>Mejn
Maryland=>Merilend
Massachusetts=>Masačusets
Michigan=>Mičigen
Minnesota=>Minesota
Mississippi=>Misisipi
Missouri=>Misuri
Montana=>Montana
Nebraska=>Nebraska
Nevada=>Nevada
New Hampshire=>Nju Hempšir
New Jersey=>Nju Džerzi
New Mexico=>Nju Meksiko
New York=>Njujork
North Carolina=>Severna Karolina
North Dakota=>Severna Dakota
Northern Marianas Islands=>Severna Marijanska Ostrva
Ohio=>Ohajo
Oklahoma=>Oklahoma
Oregon=>Oregon
Pennsylvania=>Pensilvanija
Puerto Rico=>Portoriko
Rhode Island=>Rod Ajlend
South Carolina=>Južna Karolina
South Dakota=>Južna Dakota
St. Louis=>Sent Luis
Tennessee=>Tenesi
Texas=>Teksas
Utah=>Juta
Vermont=>Vermont
Virginia=>Virdžinija
Virgin Islands =>Devičanska Ostrva
Washington=>Vašington
West Virginia=>Zapadna Virdžinija
Wisconsin=>Viskonsin
Wyoming=>Vajoming
Albuquerque=>Albukerki
Arlington=>Arlington
Atlanta=>Atlanta
Austin=>Ostin
Baltimore=>Baltimor
Boston=>Boston
Charlotte=>Šarlot
Chicago=>Čikago
Cleveland=>Klivlend
Colorado Springs=>Kolorado Springs
Columbus=>Kolambus
Dallas=>Dalas
Denver=>Denver
Detroit=>Detroit
El Paso=>El Paso
Fort Worth=>Fort Vort
Fresno=>Frezno
Honolulu=>Honolulu
Houston=>Hjuston
Indianapolis=>Indijanapolis
Jacksonville=>Džeksonvil
Kansas City=>Kanzas
Las Vegas=>Las Vegas
Long Beach=>Long Bič
Los Angeles=>Los Anđeles
Louisville=>Luivil
Memphis=>Memfis
Mesa=>Mesa
Miami=>Majami
Milwaukee=>Milvoki
Minneapolis=>Mineapolis
Nashville=>Nešvil
New Orleans=>Nju Orleans
New York=>Njujork
Oakland=>Oukland
Oklahoma City=>Oklahoma
Omaha=>Omaha
Philadelphia=>Filadelfija
Phoenix=>Finiks
Portland=>Portland
Sacramento=>Sakramento
St\. Louis=>Sent Luis
St\' Louis=>Sent Luis
San Antonio=>San Antonio
San Diego=>San Dijego
San Francisco=>San Francisko
San Jose=>San Hoze
Seattle=>Sijetl
Tucson=>Tuson
Tulsa=>Tulsa
Virginia Beach=>Virdžinija Bič
Washington=>Vašington
Wichita=>Vičita
Aberdeen=>Aberdin
Aberdeenshire=>Aberdinšir
Barnsley=>Barnsli
Belfast=>Belfast
Birmingham=>Birmingem
Bolton=>Bolton
Bradford=>Bradford
Bristol=>Bristol
Cardiff=>Kardif
Coventry=>Koventri
Derby=>Darbi
Doncaster=>Donkaster
Dudley=>Dadli
East Riding=>Ist Rajding
Edinburgh=>Edinburg
Fife=>Fajf
Glasgow=>Glazgov
Highland=>Hajland
Kirklees=>Kerkliz
Leeds=>Lids
Leicester=>Lester
Liverpool=>Liverpul
London=>London
Manchester=>Mančester
Newcastle-upon-Tyne=>Njukasl
North Lanarkshire=>Nort Lanarkšir
Nottingham=>Notingem
Oldham=>Oldham
Plymouth=>Plimut
Rhondda Cynon Taff=>Ronda Kinon Taf
Rotherham=>Roterham
Salford=>Salford
Sandwell=>Sandvel
Sefton=>Sefton
Sheffield=>Šefild
Southampton=>Sautempton
South Gloucestershire=>Saut Glosteršir
South Lanarkshire=>Saut Lanarkšir
Stockport=>Stokpot
Stoke-on-Trent=>Stouk na Trentu
Sunderland=>Sanderlend
Swansea=>Svonsi
Tameside=>Tejmsajd
Trafford=>Traford
Wakefield=>Vejkfild
Walsall=>Volsol
Wigan=>Vigan
Wirral=>Viral
Wolverhampton=>Vulverhempton
