Aaron=>Aron
Aarons=>Arons
Abbey=>Abi
Abbie=>Abi
Abbot=>Abot
Abbott=>Abot
Abe=>Ejb
Abel=>Ejbel
Abercrombie=>Aberkrombi
Abercromby=>Aberkrombi
Aberdare=>Aberder
Abigail=>Abigejl
Ackerman=>Akerman
Ackland=>Akland
Ackroyd=>Akrojd
Adair=>Ader
Addams=>Adams
Addington=>Adington
Addinsell=>Adinsel
Addison=>Adison
Adie=>Ejdi
Adrian=>Adrijan
Adrienne=>Adrijen
Aernout=>Ajernaut
Affleck=>Aflek
Agar=>Ejgar
Agassi=>Agasi
Agate=>Agat
Agnew=>Egnju
Aherne=>Ahern
Ahlberg=>Alberg
Aikman=>Ejkman
Ainge=>Ejnd
Aitchison=>Ejčison
Aitken=>Ejtken
Akroyd=>Akrojd
Albertine=>Albertina
Albright=>Olkok
Alderman=>Olderman
Aldington=>Oldington
Aldridge=>Oldrid
Alec=>Alek
Alex=>Aleks
Alexander=>Aleksander
Alexandra=>Aleksandra
Alexis=>Aleksis
Alfie=>Alfi
Alfonse=>Alfons
Algeo=>Ald
Algernon=>Ald
Alisdair=>Alister
Alistair=>Alister
Allardyce=>Alardajs
Allason=>Alason
Allbeury=>Olbjuri
Albrajt=>Olkok
Allen=>Alen
Allenby=>Alenbi
Allerton=>Alerton
Allingham=>Alingam
Allister=>Alister
Allman=>Olman
Allsop=>Olsop
Allsopp=>Olsop
Allworthy=>Olvordi
Aloysius=>Aloišus
Alwin=>Alvin
Alwyn=>Alvin
Ambrose=>Ambroz
Amelia=>Amelija
Amery=>Ejmeri
Amies=>Ejmiz
Amis=>Ejmis
Amiss=>Ejmis
Amory=>Ejmori
Anastasia=>Anastazija
Ancram=>Ankram
Andie=>Endi
Andrewes=>Endrus
Andrews=>Endrus
Andy=>Endi
Angela=>And
Angelica=>And
Angelou=>And
Angie=>End
Anglesey=>Anglsi
Anka=>Enka
Ann=>En
Anna=>Ana
Annabel=>Anabel
Annabelle=>Anabela
Annabeth=>Anabet
Anne=>En
Annear=>Anir
Annet=>Anet
Annett=>Anet
Annette=>Anet
Annie=>Eni
Annis=>Anis
Ann-Margret=>Anscombe
Antheil=>Antajl
Anthony=>Entoni
Antonia=>Antonija
Antony=>Entoni
Aphra=>Afra
Appleby=>Eplbi
Applegate=>Eplgejt
Appleton=>Eplton
Appleyard=>Epljard
Arabella=>Arabela
Arbuthnot=>Arbatnot
Arbuthnott=>Arbatnot
Archer=>Arčer
Archibald=>Arčibald
Archie=>Arči
Archy=>Arči
Arendt=>Arent
Aretha=>Areta
Argyle=>Argajl
Argyll=>Argajl
Arkwright=>Arkrajt
Arlene=>Arlin
Arliss=>Arlis
Arlott=>Arlot
Armatrading=>Armatrejding
Armey=>Armi
Armitage=>Armitid
Arne=>Arn
Arnett=>Arnet
Arnott=>Arnot
Aronoff=>Aronof
Arrowsmith=>Arousmit
Arroyo=>Arojo
Arthur=>Artur
Artie=>Art
Ascham=>Askam
Ashbee=>Ešbi
Ashbery=>Ešberi
Ashburton=>Ašberton
Ashby=>Ešbi
Ashcroft=>Eškroft
Ashdown=>Ešdaun
Ashe=>Eš
Ashford=>Ašford
Ashleigh=>Ešli
Ashley=>Ešli
Ashlie=>Ešli
Ashman=>Ešman
Ashmole=>Ešmol
Ashton=>Ešton
Askey=>Aski
Asner=>Azner
Aspell=>Aspel
Asquith=>Askvit
Assante=>Asante
Astley=>Astli
Atherton=>Aterton
Attenborough=>Etenboro
Attlee=>Atli
Attley=>Atli
Atwater=>Atvoter
Auberon=>Oberon
Aubrey=>Obri
Auchincloss=>Okinklos
Auckland=>Okland
Audrey=>Odri
Audubon=>Odubon
Augustin=>Augustus
Augustine=>Augustus
Autry=>Otri
Auty=>Oti
Avebury=>Ejvberi
Averill=>Averil
Awlinson=>Olinson
Axelrod=>Akselrod
Axworthy=>Aksvordi
Ayckbourn=>Ejkborn
Aykroyd=>Ejkrojd
Aylmer=>Ejlmer
Aylwin=>Ejlvin
Ayto=>Ejto
Ayton=>Ejton
Aytoun=>Ejton
Azinger=>Ejzinger
Babbage=>Bebid
Babbitt=>Bebit
Babcock=>Bebkok
Babington=>Bebington
Babs=>Bebs
Bach=>Bah
Bacharach=>Bakarak
Bachelor=>Bačelor
Baden=>Bejden
Baden-Powell=>Bejden-Pouel
Badham=>Badam
Bagehot=>Badžot
Bahns=>Bans
Baigelman=>Bejgelman
Bailey=>Bejli
Baillie=>Bejli
Bailly=>Bejli
Baily=>Bejli
Bainbridge=>Bejnbrid
Baird=>Berd
Bairn=>Bern
Bairstow=>Berstou
Bakewell=>Bejkvel
Balcon=>Bolkon
Baldwin=>Boldvin
Ball=>Bol
Ballantine=>Belantajn
Ballantyne=>Belantajn
Ballard=>Balard
Baltimore=>Boltimor
Bancroft=>Benkroft
Banfield=>Banfild
Banham=>Banam
Bankes=>Benks
Bankhead=>Benkhed
Banks=>Benks
Bannerman=>Benermen
Bannister=>Banister
Banville=>Banvil
Barbirolli=>Barbiroli
Bardeen=>Bardin
Baring=>Bering
Barlow=>Barlou
Barlowe=>Barlou
Barnaby=>Barnabi
Barnett=>Barnet
Barney=>Barni
Barny=>Barni
Barr=>Bar
Barraclough=>Baraklaf
Barrymore=>Barimor
Barstow=>Barstou
Barth=>Bart
Barthelme=>Bartelmi
Bartlett=>Bartlet
Baruch=>Baruk
Bashevis=>Baševis
Basinger=>Bejsinger
Bass=>Bas
Basset=>Baset
Bassett=>Baset
Batcheler=>Bačeler
Batcheller=>Bačeler
Batchellor=>Bačelor
Batchelor=>Bačelor
Bateman=>Bejtman
Bates=>Bejts
Bateson=>Bejtson
Batman=>Betmen
Battle=>Betl
Baugh=>Bo
Bauval=>Boval
Bawden=>Boden
Baxter=>Bakster
Bayley=>Bejli
Baylis=>Bejlis
Bayliss=>Bejlis
Bayly=>Bejli
Bazell=>Bazel
Beacham=>Bičam
Beadle=>Bidl
Beal=>Bil
Beals=>Bils
Beamon=>Bimon
Beardsley=>Birdsli
Beatrice=>Beatris
Beatrix=>Beatriks
Beau=>Bou
Beauchamp=>Bičam
Beaugrande=>Bogrande
Beauman=>Boman
Beaumont=>Bomont
Beaver=>Biver
Beaverbrook=>Biverbruk
Beazley=>Bizli
Bechet=>Beše
Becker=>Beker
Becket=>Beket
Beckett=>Beket
Beckford=>Bekford
Becky=>Beki
Beddoes=>Bedouz
Beddowes=>Bedouz
Beddows=>Bedouz
Beecham=>Bičam
Beerbohm=>Birbom
Beers=>Birs
Beery=>Biri
Beevor=>Bivor
Begley=>Begli
Behn=>Ben
Belloc=>Belok
Bellwood=>Belvud
Belushi=>Beluši
Benchley=>Benčli
Bendix=>Bendiks
Benedict=>Benedikt
Benett=>Benet
Benjamin=>Bend
Benn=>Ben
Bennet=>Benet
Bennett=>Benet
Bennie=>Beni
Benny=>Beni
Bentham=>Bentam
Bentinck=>Bentink
Bentine=>Bentin
Berenger=>Berend
Berenice=>Berenajsi
Berkeley=>Berkli
Berkley=>Berkli
Berkoff=>Berkof
Berlitz=>Berlic
Bernadette=>Bernadet
Bernardette=>Bernardet
Bernardine=>Bernardin
Bernice=>Bernis
Bernie=>Berni
Bernstein=>Bernstajn
Berry=>Beri
Berryman=>Beriman
Bertha=>Berta
Bertie=>Berti
Bertinelli=>Bertineli
Beryl=>Beril
Bess=>Bes
Bessemer=>Besemer
Bessey=>Besi
Bessie=>Besi
Bessy=>Besi
Beth=>Bet
Bethune=>Betjun
Betjeman=>Bečeman
Betsy=>Betsi
Bett=>Bet
Betterton=>Beterton
Betty=>Beti
Beveridge=>Beverid
Beverley=>Beverli
Beverly=>Beverli
Bewick=>Bjuik
Bewicke=>Bjuik
Bewley=>Bjuli
Biber=>Bajber
Bickerstaff=>Bikerstaf
Bickerstaffe=>Bikerstaf
Biden=>Bajden
Biddle=>Bidl
Biddulph=>Bidalf
Biffen=>Bifen
Bignell=>Bignel
Biles=>Bajls
Bill=>Bil
Billie=>Bili
Billings=>Bilings
Billingsley=>Bilingsli
Billington=>Bilington
Billy=>Bili
Binchy=>Binči
Binder=>Bajnder
Binge=>Bind
Bingham=>Bingam
Birkbeck=>Berkbek
Birkenhead=>Birkin
Birrell=>Birel
Birtwhistle=>Bishop
Birtwistle=>Bishop
Bixby=>Biksbi
Black=>Blek
Blackburn=>Blekbern
Blacket=>Bleket
Blackett=>Bleket
Blackley=>Blekli
Blackman=>Blekman
Blackmore=>Blekmor
Blackmun=>Blekmun
Blackmur=>Blekmur
Blackstone=>Blekston
Blackwell=>Blekvel
Blackwood=>Blekvud
Blain=>Blejn
Blaine=>Blejn
Blair=>Bler
Blake=>Blejk
Blakemore=>Blejkmor
Blakey=>Blejki
Blanch=>Blanč
Blanchard=>Blančard
Blashford=>Blašford
Blatty=>Blati
Bleasdale=>Blizdejl
Bledsoe=>Bledso
Bleeth=>Blit
Blessed=>Blesed
Blethyn=>Bletin
Bligh=>Blaj
Blight=>Blajt
Blishen=>Blišen
Bliss=>Blis
Bloch=>Bloh
Blondell=>Blondel
Bloom=>Blum
Bloomfield=>Blumfild
Blume=>Blum
Blundell=>Blandel
Blunkett=>Blanket
Blunt=>Blant
Bly=>Blaj
Blyton=>Blajton
Bo=>Bou
Bobbie=>Bobi
Bobby=>Bobi
Bochco=>Bočko
Bodley=>Bodli
Bogarde=>Bogard
Bolger=>Bold
Bolingbroke=>Bolingbruk
Bolinger=>Bolind
Bolitho=>Bolajto
Bollinger=>Bolind
Bonet=>Bone
Bon Jovi=>Bon Džovi
Bonney=>Boni
Bonnie=>Boni
Booker=>Buker
Boole=>Bul
Boon=>Bun
Boone=>Bun
Boorda=>Borda
Boorman=>Borman
Boorstin=>Borstin
Boothby=>Budbi
Boothroyd=>Butrojd
Borgnine=>Borgnajn
Borrow=>Borou
Bosanquet=>Bozanket
Bosco=>Bosko
Bosley=>Bozli
Bostwick=>Bostvik
Boswell=>Bozvel
Bosworth=>Bozvort
Botham=>Botam
Botting=>Boting
Bottom=>Botom
Bottome=>Botom
Bottomley=>Botomli
Bottoms=>Botoms
Bouchet=>Buše
Bourn=>Born
Bourne=>Born
Bowditch=>Baudi
Bowdler=>Baudler
Bowie=>Boui
Bowker=>Bauker
Bowling=>Bouling
Bowman=>Bouman
Bowness=>Bounes
Boxleitner=>Bokslajtner
Boyce=>Bojs
Boycott=>Bojkot
Boyd=>Bojd
Boyden=>Bojden
Boylan=>Bojlan
Boyle=>Bojl
Boyne=>Bojn
Boyson=>Bojson
Brabham=>Brabam
Bracco=>Brako
Brad=>Bred
Bradbury=>Bredberi
Braddock=>Bradok
Braddon=>Bradon
Bradlee=>Bredli
Bradley=>Bredli
Bradman=>Bredman
Bradshaw=>Bredšo
Bradstreet=>Bredstrit
Brain=>Brejn
Braine=>Brejn
Braithwaite=>Brejtvejt
Bram=>Brem
Bramble=>Brambl
Branagh=>Brana
Brandeis=>Brandajs
Branigan=>Brenigan
Brannigan=>Brenigan
Branwell=>Branvel
Brattain=>Braten
Brautigan=>Brotigan
Braxton=>Brakston
Brayfield=>Brejfild
Bream=>Brim
Breaux=>Brou
Breckinridge=>Brekinrid
Brennan=>Brenan
Brenner=>Brener
Breslin=>Brezlin
Brett=>Bret
Brewer=>Bruer
Brewster=>Bruster
Briant=>Brajant
Brice=>Brajs
Brickman=>Brikman
Bridge=>Brid
Bridgeman=>Brid
Bridgewater=>Brid
Bridgman=>Brid
Brierley=>Brajerli
Brierly=>Brajerli
Briers=>Brajers
Brigg=>Brig
Bright=>Brajt
Brightman=>Brajtman
Brigit=>Brid
Briley=>Brajli
Brinsley=>Brinsli
Brisbane=>Brizban
Bristow=>Brampton
Bristowe=>Brampton
Brite=>Brajt
Brittan=>Britan
Brittany=>Britani
Broadbent=>Brodbent
Brocklebank=>Broklbank
Broderick=>Broderik
Brodie=>Brodi
Brodsky=>Brodski
Brokaw=>Broko
Bromfield=>Bromfild
Bromige=>Bromid
Bromley=>Bromli
Brook=>Bruk
Brooke=>Bruk
Brookes=>Bruks
Brookner=>Brukner
Brooks=>Bruks
Brosnan=>Broznan
Brothers=>Braders
Brough=>Braf
Broughton=>Broton
Broun=>Brun
Brown=>Braun
Browne=>Braun
Browning=>Brauning
Brownlee=>Braunli
Brownlie=>Braunli
Brubeck=>Brubek
Brumfit=>Bramfit
Brummell=>Bramel
Brundage=>Brandid
Brundle=>Brandl
Brunt=>Brant
Bryant=>Brajant
Bryce=>Brajs
Brynner=>Briner
Brzezinski=>Bre
Buccleuch=>Baklu
Buchanan=>Bjukenan
Buchman=>Bakman
Buchwald=>Bakvold
Buck=>Bak
Buckingham=>Bakingem
Buckley=>Bakli
Bucksey=>Baksi
Bud=>Bad
Budd=>Bad
Buddy=>Badi
Buerk=>Berk
Buffett=>Bafet
Bukowski=>Bukovski
Bulfinch=>Bulfin
Bulger=>Bald
Bullivant=>Bulivant
Bulwer=>Bulver
Bumbry=>Bambri
Bunch=>Banč
Bunche=>Banč
Bundy=>Bandi
Bunting=>Banting
Bunyan=>Banjan
Burbank=>Berbank
Burch=>Berč
Burchfield=>Berčfild
Burchill=>Berčil
Burdon=>Berdon
Burgess=>Berd
Burgoyne=>Bergojn
Burk=>Berk
Burke=>Berk
Burl=>Berl
Burlington=>Berlington
Burlinson=>Berlinson
Burnet=>Bernet
Burnett=>Bernet
Burney=>Berni
Burningham=>Berningem
Burnside=>Bernsajd
Burrell=>Barel
Burridge=>Barid
Burroughes=>Berouz
Burroughs=>Berouz
Burt=>Bert
Busfield=>Basfild
Bush=>Buš
Bushnell=>Bušnel
Buster=>Baster
Butler=>Batler
Butterworth=>Batervort
Buttler=>Batler
Buttons=>Batons
Buzz=>Baz
Byford=>Bajford
Byrnes=>Berns
Byrns=>Berns
Byron=>Bajron
Bysshe=>Biš
