Aaliyah=>Alija
Aaron=>Aron
Abbey=>Abi
Abbie=>Abi
Abbot=>Abot
Abbott=>Abot
Abby=>Abi
Abe=>Ejb
Abigail=>Abigejl
Adam=>Adam
Adams=>Adams
Addison=>Adison
Adrian=>Adrijan
Afghanistan=>Avganistan
Aidan=>Ejdan
Aiden=>Ejden
Alec=>Alek
Aleksandrovich=>Aleksandrovič
Alex=>Aleks
Alexa=>Aleksa
Alexander=>Aleksander
Alexandra=>Aleksandra
Alexis=>Aleksis
Allan=>Alan
Allen=>Alen
Allenby=>Alenbi
Allerton=>Alerton
Alley=>Ali
Allingham=>Alingam
Alliott=>Aliot
Allison=>Alison
Alouette=>Aluet
Alyssa=>Alisa
Amelia=>Amelija
Amy=>Ejmi
Anderson=>Anderson
Andrea=>Andrea
Andrew=>Endru
Andrews=>Endruz
Andy=>Endi
Angel=>Ejndžel
Angelina=>Andželina
Angelou=>Andželou
Ann=>En
Anna=>Ana
Anne=>En
Annie=>Eni
Anthony=>Entoni
Ariana=>Arijana
Arianna=>Arijana
Arthur=>Artur
Ashley=>Ešli
Aubrey=>Obri
Audrey=>Odri
Austin=>Ostin
Autumn=>Otum
Ava=>Ava
Avery=>Ejveri
Ayden=>Ajden
Bailey=>Bejli
Baker=>Bejker
Barkley=>Barkli
Barnes=>Barns
Barry=>Beri
Beattie=>Biti
Beatty=>Biti
Becky=>Beki
Beijing=>Peking
Bell=>Bel
Bella=>Bela
Bellingham=>Belingham
Benjamin=>Bendžamin
Bennett=>Benet
Bernadette=>Bernadet
Beth=>Bet
Betty=>Beti
Beverley=>Beverli
Beverly=>Beverli
Biden=>Bajden
Bill=>Bil
Bishop=>Bišop
Blair=>Bler
Blairsville=>Blersvil
Blake=>Blejk
Blanch=>Blanč
Blanche=>Blanš
Bloom=>Blum
Bobbie=>Bobi
Bobby=>Bobi
Boon=>Bun
Boone=>Bun
Boyd=>Bojd
Brad=>Bred
Brandon=>Brandon
Brayden=>Brajden
Bree=>Bri
Brian=>Brajan
Brianna=>Brijana
Briant=>Brajant
Brice=>Brajs
Brickman=>Brikman
Bridge=>Bridž
Brittney=>Britni
Brody=>Brodi
Brooke=>Bruk
Brooklyn=>Bruklin
Brooks=>Bruks
Brown=>Braun
Bryan=>Brajan
Bryant=>Brajant
Burgess=>Berdžes
Butler=>Batler
Caleb=>Kejleb
Callahan=>Kalahan
Calloway=>Kalovej
Cambridge=>Kembridž
Cameron=>Kameron
Camila=>Kamila
Campbell=>Kembel
Candy=>Kendi
Carey=>Keri
Carl=>Karl
Carlos=>Karlos
Carly=>Karli
Caroline=>Kerolajn
Carrie=>Kari
Carrington=>Karington
Carrol=>Kerol
Carroll=>Kerol
Carson=>Karson
Carter=>Karter
Cassidy=>Kasidi
Cassie=>Kesi
Cathy=>Keti
Chambers=>Čejmbers
Chantal=>Šantal
Charles=>Čarls
Charley=>Čarli
Charlie=>Čarli
Charlotte=>Šarlot
Chase=>Čejs
Chicago=>Čikago
Chloe=>Kloi
Christian=>Kristijan
Christina=>Kristina
Christine=>Kristina
Christopher=>Kristofer
Church=>Čerč
Cindy=>Sindi
Claire=>Kler
Clark=>Klark
Cody=>Kodi
Cole=>Kol
Coleman=>Kolman
Colin=>Kolin
Coline=>Kolin
Colleen=>Kolin
Collins=>Kolins
Colton=>Kolton
Connely=>Koneli
Connicker=>Koniker
Conniker=>Koniker
Connor=>Konor
Constance=>Konstans
Cook=>Kuk
Cooper=>Kuper
Corey=>Kori
Corrigan=>Korigan
Costello=>Kostelo
Cotten=>Koten
Cotton=>Koton
Courtney=>Kortni
Cox=>Koks
Coyle=>Kojli
Craig=>Krejg
Curtis=>Kertis
Curtiss=>Kertis
Cynthia=>Sintija
Daily Mail=>Dejli mejl
Dale=>Dejl
Daniel=>Danijel
Danoff=>Danof
Daphne=>Dafni
Dave=>Dejv
David=>Dejvid
Davis=>Dejvis
Dawn=>Don
Day=>Dej
Dayton=>Dejton
Debbie=>Debi
Debby=>Debi
Decker=>Deker
Deeks=>Diks
Del=>Del
Delaney=>Delejni
Denny=>Deni
Destiny=>Destini
Diaz=>Dijaz
Diego=>Dijego
Dillinger=>Dilindžer
Director=>Direktor
Dominic=>Dominik
Donahue=>Donahju
Donna=>Dona
Donner=>Doner
Donny=>Doni
Dorian=>Dorijan
Doris=>Doris
Dorothy=>Doroti
Dorrell=>Dorel
Dorsey=>Dorsi
Doug=>Dag
Drake=>Drejk
Duncan=>Dankan
Dylan=>Dilan
Earl Grey=>Erl Grej
Eddie=>Edi
Edward=>Edvard
Edwards=>Edvards
Edwin=>Edvin
Einstein=>Ajnštajn
Eli=>Ilaj
Elijah=>Ilajdža
Elizabeth=>Elizabet
Ella=>Ela
Ellis=>Elis
Emily=>Emili
Emma=>Ema
Endicott=>Endikot
Eric=>Erik
Ethan=>Itan
Eva=>Iva
Evan=>Evan
Evans=>Evans
Eve=>Iv
Evelyn=>Evelin
Faith=>Fejt
Fiji=>Fidži
Filippine=>Filipini
Findlay=>Findli
Findley=>Findli
Forbes=>Forbs
Foster=>Foster
Francine=>Fransin
Franklin=>Frenklin
Fraser=>Frejzer
Frey=>Frej
Friday=>petak
Fuller=>Fuler
Gabriel=>Gejbrijel
Gabriella=>Gabrijela
Gage=>Gejdž
Gale=>Gejl
Garcia=>Garsija
Garry=>Gari
Gary=>Gari
Gates=>Gejts
Gavin=>Gavin
Genesis=>Dženesis
Geoff=>Džef
George=>Džordž
Gerald=>Džerald
Gianna=>Džijana
Gilroy=>Gilroj
Gleason=>Glison
Gower=>Gauer
Grace=>Grejs
Grady=>Grejdi
Gray=>Grej
Green=>Grin
Gregg=>Greg
Griffin=>Grifin
Gwen=>Gven
Hailey=>Hejli
Hall=>Hol
Halloween=>Halovin
Halsted=>Halsted
Hammond=>Hamond
Hank=>Henk
Hannah=>Hana
Harris=>Haris
Harrison=>Harison
Harvey=>Harvi
Harvie=>Harvi
Hawaii=>Havaji
Hawk=>Hok
Hawke=>Hok
Hawking=>Hoking
Hayden=>Hejden
Hayes=>Hejs
Hayes=>Hejz
Heath=>Hit
Hemsworth=>Hemsvort
Henderson=>Henderson
Henry=>Henri
Hentrick=>Hentrik
Hermann Weyl=>Herman Vajl
Higgins=>Higins
Hill=>Hil
Houston=>Hjuston
Howard=>Hauard
Hughes=>Hjuz
Hunter=>Hanter
Hurricane=>Uragan
Hutcherson=>Hačerson
Ian=>Ijan
Irene=>Ajrin
Isaac=>Ajzak
Isabella=>Izabela
Isadora=>Izadora
Isaiah=>Ajzaja
Jack=>Džek
Jackson=>Džekson
Jacob=>Džejkob
Jacqueline=>Džeklin
Jaden=>Džejden
Jake=>Džejk
James=>Džejms
Jamie Li Curtis=>Džejmi Li Kertis
Jamie=>Džejmi
Jane=>Džejn
Jared=>Džared
Jasmine=>Džasmin
Jason=>Džejson
Jasper=>Džasper
Jaxon=>Džekson
Jay=>Džej
Jayden=>Džejden
Jaye=>Džej
Jayne=>Džejn
Jeff=>Džef
Jeffers=>Džefers
Jefferson=>Džeferson
Jeffrey=>Džefri
Jenkins=>Dženkins
Jennifer=>Dženifer
Jenny=>Dženi
Jensen=>Džensen
Jeremiah=>Džeremaja
Jeremy=Džeremi
Jerry=>Džeri
Jessica=>Džesika
Jey=>Džai
Jill=>Džil
Jillian=>Džilijan
Jim=>Džim
Jimmy=>Džimi
Joan=>Džoun
Joanna=>Džoana
Joanne=>Džoana
Jocelyn=>Džoselin
Jodi=>Džodi
Joe=>Džo
John=>Džon
Johnny=>Džoni
Johnson=>Džonson
Jonas=>Džonas
Jonathan=>Džonatan
Jones=>Džouns
Jordan=>Džordan
Jose=>Hoze
Joseph=>Džozef
Josh=>Džoš
Joshua=>Džošua
Josiah=>Džosaja
Juan=>Huan
Judith=>Džudit
Julia=>Džulija
Julian=>Džulijan
Justin=>Džastin
Kaitlyn=>Kejtlin
Kapoor=>Kapur
Karly=>Karli
Kat=>Ket
Katherine=>Katarina
Kathryn=>Ketrin
Katniss=>Ketnis
Kayla=>Kejla
Kaylee=>Kejli
Kelly=>Keli
Kevin=>Kevin
Khloe=>Kloi
Kimberly=>Kimberli
King=>King
Kyle=>Kajl
Kylie=>Kajli
Kyra=>Kira
Lake=>Lejk
Lam=>Lem
Lana=>Lana
Landon=>Landon
Laroque=>Larok
Lauren=>Loren
Lawrence=>Lorens
Layla=>Lejla
Leah=>Lija
Lee=>Li
Leslie=>Lesli
Levi=>Livaj
Lewis=>Luis
Liam=>Lijam
Lillian=>Lilijan
Lily=>Lili
Lincoln=>Linkon
Lisa=>Lisa
Logan=>Logan
Long=>Long
Lopez=>Lopez
Lorraine=>Lorejn
Louis=>Luis
Lucas=>Lukas
Lucy=>Lusi
Luis=>Luis
Luke=>Luk
Luttrell=>Latrel
Lydia=>Lidija
Mac=>Mak
MacArthur=>Makartur
MacLaren=>MakLaren
Mackenzie=>Makenzi
Madeline=>Madelin
Madelyn=>Madelin
Madison=>Madison
Madison=>Medison
Mailer=>Mejler
Makayla=>Makejla
Manhattan=>Menhetn
Manning=>Mening
Manson=>Manson
March=>Marč
Marcus=>Markus
Marcy=>Marsi
Maria=>Marija
Mariah=>Maraja
Marie=>Mari
Marilyn=>Merilin
Marinda=>Marinda
Marjorie=>Mardžori
Marjory=>Mardžori
Martha=>Marta
Martin=>Martin
Martinez=>Martinez
Marty=>Marti
Mary=>Meri
Mason=>Mejson
Mattel=>Matel
Matthew=>Matju
Max=>Maks
Maya=>Maja
McAlister=>Makalister
McAllister=>Makalister
McLauchlin=>Maklohlin
McLaughlin=>Maklohlin
Mcgrady=>Makgrejdi
Melanie=>Melani
Mellie=>Meli
Meredith=>Meredit
Merriwick=>Merivik
Merriwicks=>Merivikove
Merrywick=>Merivik
Mia=>Mija
Michael=>Majkl
Michelle=>Mišel
Middleton=>Midlton
Mike=>Majk
Mikhail=>Mihail
Miller=>Miler
Missouri=>Misuri
Mitchell=>Mičel
Molly=>Moli
Monday=>ponedeljak
Monica=>Monika
Monroe=>Monro
Moodie=>Mudi
Moody=>Mudi
Moore=>Mur
Morgan=>Morgan
Morris=>Moris
Morrissey=>Morisi
Munro=>Manro
Murphy=>Marfi
Naomi=>Naomi
Natalia=>Natalija
Natalie=>Natali
Natasha=>Nataša
Nathan=>Nejtan
Nathaniel=>Natanijel
Neil=>Nil
Nelson=>Nelson
Nevaeh=>Navaja
New York=>Njujork
Newcastle-upon-Tyne=>Njukasl
Nicholas=>Nikolas
Nichols=>Nikols
Nick=>Nik
Nicol=>Nikol
Nightingale=>Najtingejl
Noah=>Noa
Noreen=>Norin
O'Neil=>O'Nil
O'Riley=>O'Rajli
O'Riley=>O’Rajli
Olaseni=>Olaseni
Olinsky=>Olinski
Oliver=>Oliver
Olivia=>Olivija
Ollie=>Oli
Oluwafemi=>Oluvafemi
Olympia=>Olimpija
Owen=>Oven
Paige=>Pejdž
Parker=>Parker
Patricia=>Patriša
Patrick=>Patrik
Patterson=>Paterson
Paul=>Pol
Payton=>Pejton
Peacock=>Pikok
Peacocke=>Pikok
Pearson=>Pirson
Peele=>Pil
Perez=>Perez
Perriwood=>Perivud
Perrow=>Peroe
Perry=>Peri
Pershing=>Peršing
Pete=>Pit
Peterson=>Piterson
Peyton=>Pejton
Phil=>Fil
Philip=>Filip
Phillips=>Filips
Polly=>Poli
Powell=>Pauel
Price=>Prajs
Princeton=>Prinston
Rachel=>Rejčel
Ramirez=>Ramirez
Randall=>Randal
Randolph=>Randolf
Ray=>Rej
Reed=>Rid
Rees=>Ris
Reese=>Ris
René Descartes=>Rene Dekart
Rey=>Rej
Rian=>Rajan
Richard=>Ričard
Richardson=>Ričardson
Rick=>Rik
Riley=>Rajli
Rivera=>Rivera
Robert=>Robert
Roberts=>Roberts
Robinson=>Robinson
Rodriguez=>Rodrigez
Rogers=>Rodžers
Ronnie=>Roni
Roosevelt=>Ruzvelt
Ross=>Ros
Russell=>Rasel
Ruth=>Rut
Ryan=>Rajan
Sadie=>Sedi
Sally=>Sali
Sam=>Sem
Samantha=>Samanta
Samuel=>Samjuel
Sanchez=>Sančez
Sanders=>Sanders
Sarah=>Sara
Saturday=>subota
Savannah=>Savana
Scarlett=>Skarlet
Schaefer=>Šejfer
Schaeffer=>Šejfer
Scott=>Skot
Sean=>Šon
Sebastian=>Sebastijan
Semmy=>Semi
Serenity=>Sereniti
Shannon=>Šenon
Sharp=>Šarp
Shaw=>Šo
Shaw=>Šou
Shawn=>Šon
Sheri=>Šeri
Sherree=>Šeri
Sherry=>Šeri
Shirley=>Širli
Sholokhov=>Šolohov
Simmons=>Simons
Simon=>Sajmon
Sinclaire=>Sinkler
Smith=>Smit
Sofia=>Sofija
Sophia=>Sofija
Sophie=>Sofi
Spears=>Spirs
St' Louis=>Sent Luis
Stacey=>Stejsi 
Stacie=>Stejsi
Stacy=>Stejsi
Stella=>Stela
Stephanie=>Stefani
Stephen=>Stiven
Steve=>Stiv
Stewart=>Stjuart
Stoke-on-Trent=>Stouk na Trentu
Sunday=>nedelja
Susan=>Suzan
Sweet=>Svit
Sydney=>Sidni
Sykes=>Sajks
Taffy=>Tafi
Tanner=>Taner
Tanya=>Tanja
Tarynsville=>Tarinsvil
Tate=>Tejt
Taylor=>Tejlor
Terri=>Teri
Terry=>Teri
Texas=>Teksas
Theresa=>Tereza
Thomas=>Tomas
Thompson=>Tompson
Thomson=>Tomson
Thursday=>četvrtak
Timothy=>Timoti
Tinsdale=>Tinsdal
Todd=>Tod
Tokyo=>Tokio
Torres=>Tores
Tory=>Tori
Tracy=>Trejsi
Tricia=>Triša
Trinity=>Triniti
Tristan=>Tristan
Tuesday=>utorak
Turner=>Terner
Tyler=>Tajler
Upton=>Apton
Valeria=>Valerija
Vanessa=>Vanesa
Venezuela=>Venecuela
Victoria=>Viktorija
Vincent=>Vinsent
Vinessa=>Vinesa
Voight=>Vojt
Voigt=>Vojt
Wacker=>Vaker
Wales=>Vejls
Walker=>Voker
Wallace=>Volas
Walt=>Volt
Ward=>Vord
Warton=>Vorton
Washington=>Vašington
Watson=>Votson
Wayne=>Vejn
Wednesday=>sreda
Wells=>Vels
Wendy=>Vendi
Westlake=>Vestlejk
White=>Vajt
Whiteman=>Vajtmen
Whyte=>Vajt
Wilbur=>Vilbur
Will=>Vil
William=>Vilijam
Williams=>Vilijams
Wilson=>Vilson
Wood=>Vud
Wright=>Rajt
Wyatt=>Vajat
Young=>Jang
Zachary=>Zakari
Zoe=>Zoi
Zoey=>Zoi
hurricane=>uragan
