Address=>Adresa
address=>adresa
Agent=>agent
agent=>agent
Alcohol=>Alkohol
alcohol=>alkohol
Alpha=>Alfa
Assistant=>Asistent
chocolate=>čokolada
computer=>kompjuter
congressman=>kongresmen
doctor=>doktor
yesterday=>juče
mission=>misija
million=>milion
pathogen=>patogen
protocol=>protokol
programmer=>programer
system=>sistem
Technically=>Tehnički
tradition=>tradicija
Woman=>Žena
woman=>žena
wife=>žena
two=>dva
three=>tri
four=>četiri
five=>pet
six=>šest
seven=>sedam
eight=>osam
nine=>devet
ten=>deset
quarterback=>kvoterbek
coffe=>kafa
I'm sorry=>Žao mi je
